166666515
066166666
576666686
666626666
166666665
666166660
606665606
661866667
666666616