1L6666515
06L1666L6
576666686
L6662L666
1666L6665
666166L60
606L65606
L61866667
66L66661L